Adventure in an Elevator
An Interactive Fiction by Ruth Song
Release 1 / Serial number 191116 / Inform 7 build 6M62 (I6/v6.33 lib 6/12N) SD

Corridor
You are standing in the silent, long corridor. There is a door at the east end of the Corridor.

 Along the corridor there are many rooms, but most of them are locked, except the conference room to the north.

>go east
1st Floor Staircase
Use buttons to go Up or Down.

>up
2nd Floor Staircase

>up
East Wing
There is a weird keyboard. It seems like a coded lock.

There is a screen above the keyboard.

>xxx
That's not a verb I recognise.

>alert
That's not a verb I recognise.

>go west
You can't go that way.

* * *

Adventure in an Elevator
An Interactive Fiction by Ruth Song
Release 1 / Serial number 191116 / Inform 7 build 6M62 (I6/v6.33 lib 6/12N) SD

Corridor
You are standing in the silent, long corridor. There is a door at the east end of the Corridor.

 Along the corridor there are many rooms, but most of them are locked, except the conference room to the north.

>e
1st Floor Staircase
On the wall of the staircase, you see a note: "35 Lily". What is it? A name of a lost person?

 Here in the 1st Floor Staircase, you see an elevator. Without hesitation, you go into that elevator. (Now you can press the button to go Up or Down. )

>up
2nd Floor Staircase
Now you find yourself in the 2nd Floor Staircase. Here you find another weird note: "60 Travis".

 However, the door to the 2nd floor staircase is shut tight. With nowhere else to go, you return to the elevator.

>up
3rd Floor Staircase
As expected, the door to the 3F corridor just won't budge. You find another note saying:"18 Adams". Ah, a pretty name of a young man. 

 As you go back to the elevator, you find something wrong. No matter how you press the button of 2F or 1F, they are just not working. Only the buttons above the current floor is available.

>go west
Unknown Area
This is Nowhere.

* * *

>up
3rd Floor Staircase
As expected, the door to the 3F corridor just won't budge. You find another note saying:"18 Adams". Ah, a pretty name of a young man. 

 As you go back to the elevator, you find something wrong. No matter how you press the button of 2F or 1F, they are just not working. Only the buttons above the current floor is available.

>w
The robot steps in front of you as you approach the gate. "PAASSWAAAAWRD!!"

Enter password:

>xxx
That's not a verb I recognise.

Enter password:

>alert
That's not a verb I recognise.

Enter password:

>alert
That's not a verb I recognise.

Enter password:

* * *

>w
The robot steps in front of you as you approach the gate. "PAASSWAAAAWRD!!"

Enter password:

>alert
That's not a verb I recognise.

Enter password:

* * *

>up
3rd Floor Staircase
As expected, the door to the 3F corridor just won't budge. You find another note saying:"18 Adams". Ah, a pretty name of a young man. 

 As you go back to the elevator, you find something wrong. No matter how you press the button of 2F or 1F, they are just not working. Only the buttons above the current floor is available.

>west
The robot steps in front of you as you approach the gate. "PAASSWAAAAWRD!!" it bellows.

Enter password:

>xyz
The robot folds itself up into a cube to let you pass. Now you are in the Hold. There is a door to the north of the Hold.

Hold
This is Hold.

* * *

>up
3rd Floor Staircase
As expected, the door to the 3F corridor just won't budge. You find another note saying:"18 Adams". Ah, a pretty name of a young man. 

 As you go back to the elevator, you find something wrong. No matter how you press the button of 2F or 1F, they are just not working. Only the buttons above the current floor is available.

>up
4th Floor Staircase
It's the 4th floor. As usual, you find a closed door and another note:"45 Robert". 

 Taking the note, you go back to the elevator and plan to go on.

>up
5th Floor Staircase
 "Ding!" This is 5th floor, the top level of the building. Now you must find a way out. You feel a chill on your spine. 

 At the staircase you see something different. There is also a door to the west of the staircase. Besides the door, you see a coded lock with keypad of letters from A-Z. 

 There are two notes here. A smaller one reads:"38 Eddie". 

 The larger one writes: 

 Names engraved on a lithograph. 
 The Lost People's list. 
 Young and old lined up 
 In order of age. 
 Then, the pathway opens.

The door to the west is the only way out here.

>up
You can't go that way.

>west
What's the 5-digit combination?

Enter password:

>alert
The door is finally unlocked. You find yourself in the corridor of 5th floor
Unknown Area
This is Unknown Area. You feel something eerie of this corridor. But you have no choice but going on.
 To Be Continued...

* * *

>up
5th Floor Staircase
 "Ding!" This is 5th floor, the top level of the building. Now you must find a way out. You feel a chill on your spine. 

 At the staircase you see something different. There is also a door to the west of the staircase. Besides the door, you see a coded lock with keypad of letters from A-Z. 

 There are two notes here. A smaller one reads:"38 Eddie". 

 The larger one writes: 

 Names engraved on a lithograph. 
 The Lost People's list. 
 Young and old lined up 
 In order of age. 
 Then, the pathway opens.

The door to the west is the only way out here.

>go west
The robot steps in front of you as you approach the gate. "PAASSWAAAAWRD!!" it bellows.

Enter password:

>xyz
The robot folds itself up into a cube to let you pass. Now you are in the Hold. There is a door to the north of the Hold.

Hold
This is Hold.

* * *

>up
5th Floor Staircase
 "Ding!" This is 5th floor, the top level of the building. Now you must find a way out. You feel a chill on your spine. 

 At the staircase you see something different. There is also a door to the west of the staircase. Besides the door, you see a coded lock with keypad of letters from A-Z. 

 There are two notes here. A smaller one reads:"38 Eddie". 

 The larger one writes: 

 Names engraved on a lithograph. 
 The Lost People's list. 
 Young and old lined up 
 In order of age. 
 Then, the pathway opens.

The door to the west is the only way out here.

>w
Enter passworld
Enter password:

>xx
"WRONG PASSWAAARD!" Go back and check all the clues before you go back!"

>go w
Enter passworld
Enter password:

>alert
The door is unlocked. You find yourself in an unknown area
Unknown Area
This is Unknown Area.

* * *

Adventure in an Elevator
An Interactive Fiction by Ruth Song
Release 1 / Serial number 191116 / Inform 7 build 6M62 (I6/v6.33 lib 6/12N) SD

Corridor
You are standing in the silent, long corridor. There is a door at the east end of the Corridor.

 Along the corridor there are many rooms, but most of them are locked, except the conference room to the north.

>up
You can't go that way.

>e
1st Floor Staircase
Use buttons to go Up or Down.

>up
2nd Floor Staircase

>up
3rd Floor Staircase

>up
4th Floor Staircase

>up
You can't go that way.

* * *

Adventure in an Elevator
An Interactive Fiction by Ruth Song
Release 1 / Serial number 191116 / Inform 7 build 6M62 (I6/v6.33 lib 6/12N) SD

Corridor
You are standing in the silent, long corridor. There is a door at the east end of the Corridor.

 Along the corridor there are many rooms, but most of them are locked, except the conference room to the north.

>east
1st Floor Staircase
On the wall of the staircase, you see a note: " 35 Lily". What is it? A name of a lost person?

 By the end of the 1st Floor Staircase, you see an elevator. Without hesitation, you go into that elevator. (Now you can Use buttons to go Up or Down. )

>down
You can't go that way.

>up
2nd Floor Staircase
Now you find yourself in the 2nd Floor Staircase. Here you find another weird note: "60 Trevor". 
 The door to the 2nd floor staircase is still shut tight. With nowhere else to go, you return to the elevator.

* * *

>east
1st Floor Staircase
On the wall of the staircase, you see a note: " 35 Lily". What is it? A name of a lost person?

 By the end of the 1st Floor Staircase, you see an elevator. Without hesitation, you go into that elevator. (Now you can Use buttons to go Up or Down. )

>up
2nd Floor Staircase
Now you find yourself in the 2nd Floor Staircase. Here you find another weird note: "60 Travis".

 The door to the 2nd floor staircase is still shut tight. With nowhere else to go, you return to the elevator.

>up
3rd Floor Staircase
Now you are in the 3rd Floor Staircase. As expected, the door to the corridor just doesn't budge. You find another note saying:"18 Adams". Ah, a pretty name of a young man. 

 As you go back to the elevator, you find something wrong. No matter how you press the button of the 2F or 1F, they are just not working. Only the buttons above the current floor is available.

>up
4th Floor Staircase
It's the 4th floor. As usual, you find a closed door and another note:"45 Robert". 

 Taking the note, you go back to the elevator and plan to go on.

>up
5th Floor Staircase
 "Ding!" This is 5th floor, the top level of the building. Maybe it's only your illusion, you feel that the beep from the elevator sounds a bit different from the previous ones. You feel a chill on your spine. 

 Going to the staircase of the 5th floor, you see something different. There is also a door to the west of the staircase. Besides the door, you see a coded lock with keypad of letters from A-Z. 

 There are two notes here. A smaller one reads:"38 Eddie". 

 The larger one writes: 
 Names engraved on a lithograph. 
 The Lost People's list. 
 Young and old lined up 
 In order of age. 
 Then, the pathway opens.

However, a robot the size of an Arcturan megaladon guards the way.

>go west
Enter password
Enter password:

* * *

Adventure in an Elevator
An Interactive Fiction by Ruth Song
Release 1 / Serial number 191116 / Inform 7 build 6M62 (I6/v6.33 lib 6/12N) SD

Corridor
You are standing in the silent, long corridor. There is a door at the east end of the Corridor.

 Along the corridor there are many rooms, but most of them are locked, except the conference room to the north.

>w
You can't go that way.

>e
1st Floor Staircase
On the wall of the staircase, you see a note: "35 Lily". What is it? A name of a lost person?

 Here in the 1st Floor Staircase, you see an elevator. Without hesitation, you go into that elevator. (Now you can press the button to go Up or Down. )

* * *

>up
4th Floor Staircase
It's the 4th floor. As usual, you find a closed door and another note:"45 Robert". 

 Taking the note, you go back to the elevator and plan to go on.

>up
5th Floor Staircase
 "Ding!" This is 5th floor, the top level of the building. Now you must find a way out. You feel a chill on your spine. 

 At the staircase you see something different. There is also a door to the west of the staircase. Besides the door, you see a coded lock with keypad of letters from A-Z. 

 There are two notes here. A smaller one reads:"38 Eddie". 

 The larger one writes: 
 Names engraved on a lithograph. 
 The Lost People's list. 
 Young and old lined up 
 In order of age. 
 Then, the pathway opens.

The door to the west could be unlocked, but you need to enter the correct letter combination.

>up
You can't go that way.

* * *

>west
What's the 5-digit combination?

Enter password:

>xyz
"WRONG PASSWAAARD!" Go back and check all the clues before you go back!"
 (Before enter the password, you should attempt to hit the door once to activate the coded lock)

>alert
That's not a verb I recognise.

>go west
What's the 5-digit combination?

Enter password:

>alert
The door is finally unlocked. You find yourself in the corridor of 5th floor
Unknown Area
This is Unknown Area. You feel something eerie of this corridor. But you have no choice but going on.
 To Be Continued...